11111111111111
1P00000X0000E1
1C000000000001
10001111100001
10000000000001
10000CX0000001
11111111111111
