111111111
1001
1000000X1
111111111