11111111111111111111
10P000C1C00011C01CX1
10C1C0010011001C10X1
10110001E10111000001
101000010101110C00C1
1000100001C0000000X1
10C01100011111110C01
1000110000000C000001
100C1100C00111111001
100011C00000C000X111
1C0001111110000000C1
10C00000C011C111C001
11111111000001111111
11111111111111111111