11111111111
1X000EC0001
1E000000P11
11111111111