111111111111
1ECP0ndshu11
1000000000X1
111111111111