11111111
1EC00CX1
1P00C111
10111111