11111111111
1X000000P11
11111111111