11111111111
11X000E00P1
11111111111