111111111
1P0000E01
1000P00X1
111111111