11111111111111
1P00000000C0E1
1CX001C1000001
100011111X0001
10C001C1000001
10000000000C01
11111111111111